20
20
11111111111111111111
10000000000000000001
10000000000000020001
10000000000000000001
10000000000000000001
10000000000000000001
10000000001070809001
10000000000000000001
10000000000000000001
10000000000000000001
10000000000000000001
10000000000000000001
10000000000000000001
10000000000001000001
10000000000000000001
10000000000000000001
10300000000000000001
10000000000000000001
10000000000000000001
11111111144111111111
