20
20
11111111111111111111
10000000000000000001
10000000300000000001
10000000000000000001
10000000000003000001
10000000000000000101
10000000000000000001
10000000003000100001
10000000000000000001
10000000000000000001
10000000000000000001
10000000000000300001
10000000000000000001
10000000000000000001
10000000000000000001
10000000700000000001
10000000000000000001
10000000600000000001
10000000000000000001
11111111144111111111
