20
20
11111111111111111111
10000000000000000001
10000000000000000001
10000000000000000001
10000000000000000001
10000000000000000001
10000000001000000001
10000000000000000001
10000000000070000001
10000000000000000001
10000000000000800001
10000000000000000001
10000000000000009001
10000000000001000001
10000000000000000001
10000000000000000001
10000000000000000001
10000000000000000001
10000000000000000001
11111111144111111111
