20
20
11111111111111111111
10000000000000000001
10000000300000000001
10000000000000000001
10000000300000000001
10000000000000000101
10000000000000000001
10000000300000100001
10000000000000000001
10000000000000000001
10000000000000000001
10000000000000100001
10000000000000000001
10000000000000000001
10000000000000000001
10000000000000000001
10000000000000000001
10000000000000000001
10000000000000000001
11111111144111111111
