20
20
11111111144111111111
10000000000000000001
10011110000001111001
10011110000001111001
10011110000001111001
10011110000001111001
10000000000000000001
10000000000000000001
10000000000000000001
10000011111111000001
10000000000000000001
10000000000000000001
10000000000000000001
10000000000000000001
10011110000001111001
10011110000001111001
10011110000001111001
10011110000001111001
10000000000000000001
11111111144111111111
