20
20
11111111111111111111
13011000000300000001
10000000100000001001
10010010000000100001
10000000000000000001
13001000011000001001
10000000000000000001
11100001100011000001
10001000000000000001
10001000100000000004
10010000001100000004
10001000001100000001
10000000000000100001
10000010000000000001
10030001000010010001
10011000100000000001
10011000010000000001
10000010001003003001
10300000000100000001
11111111144111111111
