20
20
11111111144111111111
10000000000000000001
10011001100000110001
13011001100000110001
10000000000000000001
10000000011000000301
10110000011000000001
10110000000000000001
10001100000000110001
40001100000000110001
40000000000000000001
10001100000000000001
10001100001100000001
10030000001100000001
10000000000000030001
10000000110000000001
10011000110000110001
10011000000000110001
10000000003000000001
11111111111111111111
