20
20
11111111144111111111
10000000000000000001
10000000000000000001
10011111111111111001
10010108000030101001
10013010030001001001
10010001100110001001
10010030000003101001
10010010010001001001
10010001001000101001
10010300100000001001
10010001000010301001
10010100000100101001
10010300010000001001
10010010003010301001
10010000000000001001
10011111000011111001
10000000000000000001
10000000000000000001
11111111111111111111
