20
20
11111111111111111111
10000000000000000001
10100000000001010001
10000111100000100001
10001000010001010001
10010000001000000001
10100000000100000001
10000011000010000001
10000000000001111111
11000011000000000004
11000000000000000004
10000000000001111111
10000011000010000001
10100000000100000001
10010000001000000001
10001000010000110001
10000111110000110001
10000000000000000001
10000010000000000001
11111111111111111111
