20
20
11111111111111111111
10000000000000000001
10100000000001010701
10000111100000100001
10001000010001010001
10010000001000000001
10100030000100000001
10030011000010000001
10030030000001111111
11030011000000000004
11030030000000000004
10030000000001111111
10030011000010000001
10130030000100000001
10010000001000000001
10001000010000110001
10000111110000110001
10000000000000000001
10000010000000000001
11111111111111111111
