20
20
11111111144111111111
10000000000000000001
10001110000000100001
10001110001000010001
10001110000011001101
10000000000000000001
10000110000010001001
10001000000000000001
10010000000100010001
40010110000000000001
40000001000000100001
10000000000000011001
10000000000011000001
10001000000000000001
10100001000000001001
10000000000100000001
10000001100000000001
10000011000011000001
10010000000000001001
11111111144111111111
