20
20
11111111144111111111
13000000000000000031
10001110000000100001
10001110001000010001
10001110000011001101
10000000000000030001
10000110000010001001
10001000000000000001
10013000000100010001
40010110000000000001
40000001003300100001
10003000000000011001
10000000000011000001
10001000000000000001
10100001000000001001
10000000000100000001
10000001100000300001
10000011000011000001
13010000000000001031
11111111144111111111
