20
20
11111111144111111111
10000000000000000001
10000100000000100001
10000100111100100001
10003100111100130001
10111100111100111101
10000000111100000001
10100010000000011001
10010100003000000001
10001000030300010004
10010100003000010004
10100010000000000001
10000000000000011001
10000000111100000001
10111100111100111101
10003100111100130001
10000100111100100001
10000100000000100001
10000000000000000001
11111111144111111111
