20
20
11111111111111111111
10000000033000000001
10000000033000000001
10011111111111111001
10011111111111111001
10011111111111111001
10011111111111111001
10011111111111111001
10011111111111111001
40011111111111111004
40011111111111111004
10011111111111111001
10011111111111111001
10011111111111111001
10011111111111111001
10011111111111111001
10011111111111111001
10000000003300000001
10000000003300000001
11111111111111111111
