20
20
11111111111111111111
10101010101010101011
10010000000000000001
10101010101010101011
10000000000000000001
10101010101010101011
10000001000000010001
10101010101010101011
10000000000000010001
40101010101010101004
40000001000000000004
11101010101010101011
10000000000000000001
10101010101010101011
10000000000000000001
10101010101010101011
10000100000000010001
10101010101010101011
10000000000000000001
11111111111111111111
