20
20
11111111111111111111
10101010101010101011
10010003000000000301
10101010101010101011
10000000000300000001
10101010101010101011
10000001000000010001
10101010101010101311
10000003000000010001
40101010101010101004
40000001000300000004
11101010101010101011
10000000000000000001
10101010101010101011
10000000000000000001
10101010101010101011
10030100030000010301
10101010101010101011
10000000000000000001
11111111111111111111
