20
20
11111111111111111111
10000000000000000001
10000000000000000001
11111111110011111001
10000000000000001001
10110000000000001001
10110000000000001001
10000000000000001001
10000000000000001001
40000000000000001001
40000000000000001001
10000000000000001001
10000000000000001001
10000000000000001001
10000000000000001001
10000000111111111001
10000000100000000001
10000000100000000001
13333333100000000001
11111111144111111111
