20
20
11111111111111111111
10000000000000000001
10000000000000000001
10000000000000000001
10000000000000000001
10000000000000000001
10000000000000000001
10000000000000000001
10000000000000000001
10000000000000000004
10000000600000000004
10000000000000000001
10000000000000000001
10000000000000000001
10000000000000000001
10000000700000000001
10000000000000000001
10000000000000000001
10000000000000000001
11111111144111111111
