20
20
11111111111111111111
10000000000000000001
10000100301000000001
10000000000000000001
10000000000000000001
10010000000000000001
10000000000001000001
10000010000001000001
10000000000001000001
10000000000001000004
10100000000001030004
10000000010001111111
10000000000000000001
10000000000010000001
10003000000000000001
10011100000000000001
10000000000000011001
10000000000000011001
10000000000000000001
11111111144111111111
