20
20
11111111144111111111
13001000000001000001
10100000000010011001
10000000111100011001
10001001000000000001
10300010030000000001
10001100000000010031
10011080030000001001
10011000000010000111
10000110030100000001
10000001001000010301
10010000110030000001
10000110110000001001
10000110010001000001
10000000010000000001
10100003010000011101
10000100000100000001
10000000001110003001
13311000000000000001
11111111111111111111
