20
20
11111111144111111111
10001000000001000001
10100000000010011001
10000000111100011001
10001001000000000001
10000010000000000001
10001100000000010001
10011000000000001001
10011000000010000111
10000110000100000001
10000001001000010001
10010000110000000001
10000110110000001001
10000110010001000001
10000000010000000001
10100000010000011101
10000100000100000001
10000000001110000001
10011000000000000001
11111111144111111111
