20
20
11111111144111111111
10000000000000000031
10100000000001100001
10100000000000000001
10000100011000110001
10003100000000000001
10011000000101100001
10000011000100311001
10000000001100010001
10001010030000000004
10000100000110000004
10301013000003000001
10000000011000000001
10001110010000110001
10001010000000000001
10000100000010000001
10130001100010000001
10110000000000003001
10000000000000000001
11111111111111111111
