20
20
11111111144111111111
10000000000000000001
10100000000001100001
10100000000000000001
10000100011000110001
10000100000000000001
10011000000101100001
10000011000100011001
10000000001100010001
10001010000000000004
10000100000110000004
10001010000000000001
10000000011000000001
10001110010000110001
10001010000000000001
10000100000010000001
10100001100010000001
10110000000000000001
10000000000000000001
11111111111111111111
