20
20
11111111111111111111
10000000100000011001
10001000000101000001
10000111100000011111
10000001101000000001
10110001100011000001
10110000100110000001
10000000111100000001
11111111100000001101
40000000100000001101
40001100100010000001
10000000100000111111
10010000101000111111
10000010100000111111
10100000100000000001
10000000100000000001
10100100111111001101
10110000000010001101
10000001000000000001
11111111111111111111
