20
20
11111111111111111111
10000000100000011031
10001000000101000001
10000111100000011111
10000001101000003301
10110001100011000001
10110900130110000001
10000000111100000001
11111111100003001101
40000003103000001101
40001100100010000001
10000000100000111111
10010000101000111111
10000010100000111111
10100000100000000031
10003000100300000001
10100100111111001101
10110000000010001101
10000001000300000001
11111111111111111111
