20
20
11111111111111111111
10000000000000000001
10011111111111111001
10010000000000001001
10010000000000001001
10010011000011001001
10010011060011001001
10010000000000001001
10010000000000001001
10010000000000001004
10010000000000001004
10010000000000001001
10010011000011001001
10010011000011001001
10010000000000001001
10010000000000001001
10011111100111111001
10000000000000000001
10000000000000000001
11111111111111111111
