20
20
11111111144111111111
10000000100100000001
10001100100100011001
10001100100100011001
10000000100100000001
10011111100111111111
10010000000000000001
10010000000000000001
11110000000000000001
40010000000000000001
40010000000000000001
10010000000000000001
10010000000000000001
10010000000000000001
10010000000000000001
10013333333333333331
10011001111111111111
10000000000000000001
10000000000000000001
11111111111111111111
