20
20
11111111111111111111
10000000000000000001
10060600066000600601
10006000600600600601
10006000066000066001
10000000000000000001
10000000000000000001
10000000000000000001
10600600600600600601
10606060600600660601
10060006000600606601
10000000000000000001
10000000000000000001
10000000000000000001
10000000000000000001
10000000000000000001
10000000000000000001
10000000000000000001
10000000000000000001
11111111111111111111