20
20
11111111111111111111
10000000000000000001
10010030100000010001
10000000000000000001
10000000000003000001
10000000000011000001
10000100000000000001
10000000000000000001
10000001000000001001
40000000000000000001
40000000000000000001
10000000000001110001
10000000000000000001
10000001000100000001
10000010000000000001
10000100000000110001
10001003000000000001
10010000000000030001
10000000000000000001
11111111144111111111
