20
20
11111111111111111111
10000110003000000001
10300000000000100301
10011000000000000001
10000000001000000001
10000100000000111001
10000000300000000001
10100000000000000001
10000100001000000001
10000000000000000004
10000000000033000004
10010000000111100001
10000000000111100001
10000100000111100001
10000000000000000001
10000000000000000001
10011000000000011001
10011000000000011001
10030000000000000001
11111111144111111111
