20
20
11111111111111111111
10000001100000000001
10030000000001100301
10000110000001100001
10100000000000000001
10000001100000000001
10000000000100030001
10000100000010000001
10000000001001000001
40000000000110001001
40000100000100000001
10000000001000000301
10000000010030000001
10000001100000010001
10000001100010000001
10000000100000003001
10000000100100000001
10033001000000011001
10000010000000000001
11111111144111111111
