20
20
11111111144111111111
10000000000000000001
10000000000000000001
10000000000000000001
10000000000000000001
10000000000000000001
10000010000000000001
10000000000000000001
10000000000000000001
10000000000000000004
10000000000000000004
10000000010000000001
10000000000000000001
10000000000000000001
10000000000000000001
10000000000000000001
10010000000000000001
10000000000000000001
10000000000000000001
11111111111111111111
