20
20
11111111144111111111
10000000000000000001
10000000000000110001
10000000000000000001
10000000000000000001
10000000000000300001
10000100000000000001
10000000000000000001
10000000000000000001
40000000000000100001
40000000000000000001
10000000000000000001
10000000000000000001
10010000000000000001
10000000000000100001
10000000000000100001
10000000000000130001
10000000000000100001
10000000000000000001
11111111144111111111
