20
20
11111111144111111111
10000000000000000001
10000000000000000001
10000000001100001001
10110000000000000001
10010000000000000001
10001000000000000001
10000000000001000001
10000001000000000001
10100000000001000004
10000000000100000004
10000010000000000001
10000000000000000001
10001000010000010001
10000000000000000001
11100000000000000001
10000000000000001001
10000001111110000001
10000000000000000001
11111111144111111111
