20
20
11111111144111111111
10000000000000000001
10010001000000001001
10000000000010000001
10000001000000000001
10100000000000100001
10010000000100000101
10000000100000000001
10010000000000100001
40000000100000000001
40000010000100000001
10000000000000100001
10000000010000010001
10000010000000000001
10010000000100000001
10000000000000000001
10000000100000010001
10001000000000000001
10000001000010000001
11111111111111111111
